併	倂
厩	廏
俞	兪
值	値
偷	偸
即	卽
告	吿
唧	喞
鄉	鄕
喻	喩
塈	墍
填	塡
妍	姸
媮	婾
尚	尙
屏	屛
帡	帲
惪	悳
慎	愼
既	旣
暨	曁
概	槪
榆	楡
槙	槇
清	淸
溉	漑
真	眞
研	硏
箳	簈
胼	腁
迸	逬
郎	郞
青	靑
俱	倶
查	査
瓶	甁
豜	豣
熙	煕
教	敎
軿	輧
鄉	鄕
鈃	銒
鎮	鎭
顛	顚
駢	騈
飲	飮
餅	餠
巔	巓
緒	緖
磙	𥕦
𨍽	𨎊
浄	淨
殻	殼
慤	𢡱
燷	燣
癝	癛
㑺	儁
㻪	㻽
㩗	𢹂